"aa" = (/turf/wall/tree,/area)
"ab" = (/obj/weapon/blade,/turf/floor/grass,/area)
"ac" = (/turf/floor/grass,/area)
"ad" = (/mob/bug,/turf/floor/grass,/area)
"ae" = (/mob/moth,/turf/floor/grass,/area)
"af" = (/obj/warp/east1to2,/turf/floor/grass,/area)
"ag" = (/obj/healer,/turf/floor/grass,/area)
"ah" = (/turf/floor/snow,/area)
"ai" = (/obj/warp/north2to12,/turf/floor/snow,/area)
"aj" = (/obj/warp/west2to1,/turf/floor/grass,/area)
"ak" = (/obj/person/girl,/turf/floor/grass,/area)
"al" = (/obj/warp/south2to4,/turf/floor/grass,/area)
"am" = (/turf/wall/fort,/area)
"an" = (/obj/warp/east2to3,/turf/floor/grass,/area)
"ao" = (/obj/warp/west2to4,/turf/floor/grass,/area)
"ap" = (/obj/warp/east2to9,/turf/floor/grass,/area)
"aq" = (/obj/warp/north2to4,/turf/floor/grass,/area)
"ar" = (/obj/warp/south2to6,/turf/floor/grass,/area)
"as" = (/obj/warp/north34to5,/turf/floor/hall,/area)
"at" = (/turf/floor/town/before,/area)
"au" = (/turf/floor/hall,/area)
"av" = (/obj/guard/towntohall,/turf/floor/hall,/area)
"aw" = (/turf/wall/stall,/area)
"ax" = (/obj/warp/west3to2,/turf/floor/town/before,/area)
"ay" = (/obj/warp/north4to2,/turf/floor/town/after,/area)
"az" = (/turf/floor/town/after,/area)
"aA" = (/obj/guard/northgate,/turf/floor/town/after,/area)
"aB" = (/obj/person/generic,/turf/wall/stall,/area)
"aC" = (/obj/shop/armoury,/turf/floor/town/after,/area)
"aD" = (/obj/warp/west3to2,/turf/floor/town/after,/area)
"aE" = (/obj/guard/westgate,/turf/floor/town/after,/area)
"aF" = (/obj/warp/east4to2,/turf/floor/town/after,/area)
"aG" = (/obj/shop/potion,/turf/floor/town/after,/area)
"aH" = (/obj/shop/inn,/turf/floor/town/after,/area)
"aI" = (/obj/guard/southgate,/turf/floor/town/after,/area)
"aJ" = (/obj/warp/south4to2,/turf/floor/town/after,/area)
"aK" = (/obj/warp/north5to34,/turf/floor/hall,/area)
"aL" = (/obj/weapon/cross,/boss/king,/turf/floor/hall,/area)
"aM" = (/obj/guard/kinghall,/turf/floor/hall,/area)
"aN" = (/obj/guard/hallvist,/turf/floor/hall,/area)
"aO" = (/obj/guard/halltrue,/turf/floor/hall,/area)
"aP" = (/obj/guard/hallarm,/turf/floor/hall,/area)
"aQ" = (/obj/warp/north6to2,/turf/floor/grass,/area)
"aR" = (/obj/person/sand,/turf/floor/grass,/area)
"aS" = (/turf/floor/sand,/area)
"aT" = (/turf/wall/sand,/area)
"aU" = (/obj/flag,/turf/floor/sand,/area)
"aV" = (/obj/warp/south6to7,/turf/floor/sand,/area)
"aW" = (/obj/warp/north7to6,/turf/floor/sand,/area)
"aX" = (/turf/floor/moth,/area)
"aY" = (/turf/wall/moth,/area)
"aZ" = (/mob/moth,/turf/floor/sand,/area)
"ba" = (/obj/weapon/staff,/boss/moth,/turf/floor/sand,/area)
"bb" = (/turf/floor/flower,/area)
"bc" = (/turf/wall/water,/area)
"bd" = (/turf/wall/cave,/area)
"be" = (/obj/person/wise,/turf/floor/grass,/area)
"bf" = (/mob/ranged/bug,/turf/floor/grass,/area)
"bg" = (/turf/floor/earth,/area)
"bh" = (/turf/wall/shade,/area)
"bi" = (/mob/moth,/turf/floor/earth,/area)
"bj" = (/obj/warp/eastmanto9,/turf/floor/earth,/area)
"bk" = (/mob/ranged/moth,/turf/floor/grass,/area)
"bl" = (/mob/ranged/bug,/turf/floor/earth,/area)
"bm" = (/mob/armoured_moth,/turf/floor/earth,/area)
"bn" = (/obj/warp/west9to2,/turf/floor/grass,/area)
"bo" = (/mob/armoured_bug,/turf/floor/grass,/area)
"bp" = (/mob/armoured_bug,/turf/floor/earth,/area)
"bq" = (/turf/floor/earth/ruin,/area)
"br" = (/obj/warp/east9to10,/turf/floor/earth/ruin,/area)
"bs" = (/mob/armoured_moth,/turf/floor/grass,/area)
"bt" = (/obj/warp/west9toman,/turf/floor/earth,/area)
"bu" = (/mob/ranged/moth,/turf/floor/cave,/area)
"bv" = (/turf/floor/cave,/area)
"bw" = (/mob/poisoned/bug,/turf/floor/cave,/area)
"bx" = (/mob/armoured_moth,/turf/floor/cave,/area)
"by" = (/mob/armoured_bug,/turf/floor/cave,/area)
"bz" = (/mob/bug,/turf/floor/earth,/area)
"bA" = (/mob/ranged/bug,/turf/floor/cave,/area)
"bB" = (/obj/warp/west10to9,/turf/floor/earth,/area)
"bC" = (/obj/warp/east10to11,/turf/floor/cave,/area)
"bD" = (/turf/wall/dark,/area)
"bE" = (/obj/weapon/spear,/boss/thief,/turf/floor/cave,/area)
"bF" = (/turf/wall/crack,/area)
"bG" = (/turf/floor/dark,/area)
"bH" = (/turf/wall/hall,/area)
"bI" = (/obj/warp/warpEscape,/turf/floor/dark,/area)
"bJ" = (/mob/unbreakable/bug,/turf/floor/dark,/area)
"bK" = (/mob/unbreakable/moth,/turf/floor/dark,/area)
"bL" = (/mob/moth,/turf/floor/cave,/area)
"bM" = (/obj/weapon/force,/turf/floor/dark,/area)
"bN" = (/mob/bug,/turf/floor/cave,/area)
"bO" = (/mob/armoured_bug,/turf/floor/dark,/area)
"bP" = (/mob/armoured_moth,/turf/floor/dark,/area)
"bQ" = (/mob/bug,/turf/floor/dark,/area)
"bR" = (/mob/moth,/turf/floor/dark,/area)
"bS" = (/mob/poisoned/bug,/turf/floor/dark,/area)
"bT" = (/mob/poisoned/moth,/turf/floor/dark,/area)
"bU" = (/obj/warp/west11to10,/turf/floor/cave,/area)
"bV" = (/obj/potion,/turf/floor/snow,/area)
"bW" = (/obj/crack,/turf/floor/snow,/area)
"bX" = (/turf/wall/snow,/area)
"bY" = (/obj/warp/warpQ1,/turf/floor/warp/Q1,/area)
"bZ" = (/obj/warp/warpH2,/turf/floor/warp/H2,/area)
"ca" = (/obj/warp/warpU2,/turf/floor/warp/U2,/area)
"cb" = (/obj/warp/warpD2,/turf/floor/warp/D2,/area)
"cc" = (/obj/warp/warpT2,/turf/floor/warp/T2,/area)
"cd" = (/obj/warp/south12to2,/turf/floor/snow,/area)
"ce" = (/obj/warp/warpA2,/turf/floor/warp/A2,/area)
"cf" = (/obj/warp/warpA1,/turf/floor/warp/A1,/area)
"cg" = (/obj/warp/warpG1,/turf/floor/warp/G1,/area)
"ch" = (/obj/warp/warpB1,/turf/floor/warp/B1,/area)
"ci" = (/obj/warp/warpE1,/turf/floor/warp/E1,/area)
"cj" = (/obj/warp/warpN2,/turf/floor/warp/N2,/area)
"ck" = (/obj/warp/warpU1,/turf/floor/warp/U1,/area)
"cl" = (/obj/warp/warpK2,/turf/floor/warp/K2,/area)
"cm" = (/obj/warp/warpBoss,/turf/floor/snow,/area)
"cn" = (/obj/warp/warpD1,/turf/floor/warp/D1,/area)
"co" = (/obj/warp/warpR1,/turf/floor/warp/R1,/area)
"cp" = (/obj/warp/warpT1,/turf/floor/warp/T1,/area)
"cq" = (/obj/warp/warpL2,/turf/floor/warp/L2,/area)
"cr" = (/obj/warp/warpL1,/turf/floor/warp/L1,/area)
"cs" = (/obj/warp/warpI2,/turf/floor/warp/I2,/area)
"ct" = (/obj/potion,/turf/floor/warp/M1,/area)
"cu" = (/obj/warp/warpE2,/turf/floor/warp/E2,/area)
"cv" = (/obj/warp/warpR2,/turf/floor/warp/R2,/area)
"cw" = (/obj/warp/warpS1,/turf/floor/warp/S1,/area)
"cx" = (/obj/person/dead,/turf/floor/snow,/area)
"cy" = (/obj/warp/warpN1,/turf/floor/warp/N1,/area)
"cz" = (/obj/warp/warpP2,/turf/floor/warp/P2,/area)
"cA" = (/obj/warp/warpC2,/turf/floor/warp/C2,/area)
"cB" = (/obj/warp/warpQ2,/turf/floor/warp/Q2,/area)
"cC" = (/obj/warp/warpJ2,/turf/floor/warp/J2,/area)
"cD" = (/obj/warp/warpM2,/turf/floor/warp/M2,/area)
"cE" = (/obj/warp/warpF2,/turf/floor/warp/F2,/area)
"cF" = (/obj/warp/warpF1,/turf/floor/warp/F1,/area)
"cG" = (/obj/warp/warpO1,/turf/floor/warp/O1,/area)
"cH" = (/obj/warp/warpK1,/turf/floor/warp/K1,/area)
"cI" = (/obj/warp/warpB2,/turf/floor/warp/B2,/area)
"cJ" = (/obj/warp/warpC1,/turf/floor/warp/C1,/area)
"cK" = (/obj/warp/warpG2,/turf/floor/warp/G2,/area)
"cL" = (/obj/warp/warpS2,/turf/floor/warp/S2,/area)
"cM" = (/obj/warp/warpO2,/turf/floor/warp/O2,/area)
"cN" = (/obj/warp/warpP1,/turf/floor/warp/P1,/area)
"cO" = (/obj/warp/warpH1,/turf/floor/warp/H1,/area)
"cP" = (/obj/warp/warpI1,/turf/floor/warp/I1,/area)
"cQ" = (/obj/warp/warpJ1,/turf/floor/warp/J1,/area)
"cR" = (/mob/poisoned/fruit,/turf/floor/dark,/area)
"cS" = (/boss/fruit,/turf/floor/dark,/area)
"cT" = (/turf,/area)
"cU" = (/turf/floor/hall{pixel_x = -16},/area)

(1,1,1) = {"
aaaaaaaaaaaaaaaaaaaaaaaaaaaaaaaaaa
aaabaaacadacacacacacadacacacacacaa
aaaeaaacaaacaaaaacadacaaaaacaaadaa
aaacaaacaaacacaaadaaacaaacaaaaacaa
aaacaaacaaaaaaaaacaaacaaacadacacaa
aaadaaacacacacacacaaacacacacaaaaaa
aaacaaaaadaaadaaaaaaaaaaaaacaaacaf
aaacaaacacaaacacacaaacacadacaaacaa
aaacaaacaaaaaaaaacaaaaaaaaacaaadaa
aaadaaacadacacacacacacacadacacacaa
aaacaaadaaaaaaaaadaaadaaacaaaaacaa
aaacaaacaaagadaaacaaacaaacacaaacaa
aaacaaacaaaaacaaacaaacaaaaacaaadaa
aaadaaacacaaacacacaaacacaaacaaacaa
aaacaaaaaaaaaaaaaaaaaaaaaaacaaacaa
aaacacacacacacacacacacadacacacacaa
aaaaaaaaaaaaaaaaaaaaaaaaaaaaaaaaaa
"}

(1,1,2) = {"
ahahahaiahahahahahahahahahahaaaaaa
aaacacacacacacacacacacaaaaaaaaacac
aaacacacacacacacacacacaaaaacacacac
aaacacacacacacacacaaaaacaaacacacac
aaacacacacacacacacaaaaaaaaacaaaaac
aaaaaaaaaaaaaaaaacaaacacacacacaaac
ajacaaakacacacaaalaaacacaaacaaaaac
aaacaaaaaaaaacamamamaaaaaaacaaacac
aaacaaacacacanamamamaoacacacacacap
aaacacacacacacamamamacacacaaacaaac
aaaaaaaaaaaaaaaaaqaaaaacacaaaaaaac
acaaacacacacacacacacaaaaacaaacaaac
acacaaacacacacacacacacaaaaacacacac
acaaacacacacacacacacacacaaaaacacac
aaacacacacacacacacacacacacaaaaacac
aaacacacacacacacacacacacacacaaaaaa
aaaracacacacacacacacacacacacacaaaa
"}

(1,1,3) = {"
amamasamamamamamatamamamamamamamam
amauavauamatatatatatatatatawawawam
amauauauamatatatatatatatatawawawam
amatatatatatatatatatatatatatatatam
amatatatatatatatatatatatatatatatam
amatatatatatatatatatatatatatatatam
amatatatatatatatatatatatatatatatam
amatatatatatatatatatatatatatatatam
axatatatatatatatatatatatatatatatat
amatatatatatatatatatatatatatatatam
amawawatatatatatatatatatatatatatam
amawawatatatatatatatatatatatawawam
amawawatatatatatatatatatatatawawam
amawawatatatatatatatatatatatawawam
amawawatatatatatatatatatatatawawam
amawawatatatatatatatawawawawawawam
amamamamamamamamatamamamamamamamam
"}

(1,1,4) = {"
amamasamamamamamayamamamamamamamam
amauauauamazazazaAazazazazawaBawam
amauauauamazazazazazazazazawaCawam
amazazazazazazazazazazazazazazazam
amazazazazazazazazazazazazazazazam
amazazazazazazazazazazazazazazazam
amazazazazazazazazazazazazazazazam
amazazazazazazazazazazazazazazazam
aDazazazazazazazazazazazazazazaEaF
amazazazazazazazazazazazazazazazam
amawawazazazazazazazazazazazazazam
amawawazazazazazazazazazazazawawam
amawawazazazazazazazazazazazawawam
amaBaGazazazazazazazazazazazawawam
amawawazazazazazazazazazazazaHaBam
amawawazazazazazaIazawawawawawawam
amamamamamamamamaJamamamamamamamam
"}

(1,1,5) = {"
amauaKauamamamamamamamamamamamamam
amauauauamauauauamamamauauauamamam
amauauauamauamauamamamauaLauamamam
amauauauaMauamauamamamauauauamamam
amamamamamamamauamamamamauamamamam
amauauauauauauauamamamauauauamamam
amauamamamamamamamamamauauauamamam
amauauauauauauaNauamauauauauauamam
amamamamamamamauamauauauauauauauam
amauauauauauauauamauamamamamamauam
amauamamamamamamamaOauauauauamauam
amauauauauauauauauauamauauauamauam
amauamamamamamamamauamauauauamauam
amauamauauauauauauauamamamaPamauam
amauamauamamamamamamauauauauauauam
amauauauauauauauauamauauauauauauam
amamamamamamamamauamamamamamamamam
"}

(1,1,6) = {"
aQacacacacacacacacacacacacacacacaR
acacacacacacacacacacacacacacacacac
acacacacacacacacacacacacacacacacac
aSaSaSaSaSaSaSaSaSaSaSaSaSaSaSaSaS
aSaSaSaSaSaSaSaSaSaSaSaSaSaSaSaSaS
aSaSaSaSaSaSaSaSaSaSaSaSaSaSaSaSaS
aTaUaTaTaTaTaTaTaUaTaTaTaTaTaTaUaT
aTaSaTaTaSaSaTaTaSaTaTaTaTaSaTaSaT
aTaSaSaSaTaSaSaSaSaSaSaSaTaSaTaSaT
aTaSaTaTaTaTaTaTaSaTaTaSaTaSaSaSaT
aTaSaTaSaSaSaTaTaSaSaTaSaTaSaTaSaT
aTaSaSaSaTaSaTaSaSaTaTaSaSaSaTaSaT
aTaSaTaTaTaSaTaTaSaTaTaTaTaTaTaSaT
aTaSaTaSaSaSaTaTaSaSaSaSaSaSaSaSaT
aTaTaTaUaTaTaTaTaTaTaTaTaTaTaTaTaT
aSaSaSaSaSaSaSaSaSaSaSaSaSaSaSaSaS
aSaSaSaSaSaSaSaSaSaSaSaSaSaSaSaSaV
"}

(1,1,7) = {"
aSaSaSaSaSaSaSaSaSaSaSaSaSaSaSaSaW
aSaSaSaSaSaSaSaSaSaSaSaSaSaSaSaSaS
aSaSaSaSaSaSaSaSaXaSaSaSaSaSaSaSaS
aSaSaSaYaYaYaYaYaXaYaYaYaYaYaSaSaS
aSaSaSaYaZaXaZaXaZaXaYaXaYaYaSaSaS
aSaSaSaYaXaYaYaYaYaXaYaXaYaYaSaSaS
aSaSaSaYaXaZaXaYaYaZaZaXaYaYaSaSaS
aSaSaSaYaYaYaYaYaYaYaYaYaYaYaSaSaS
aSaSaXaXaZaYaXaZbaaYaXaYaZaXaXaSaS
aSaSaSaYaXaYaXaYaYaYaXaYaXaYaSaSaS
aSaSaSaYaXaYaXaYaYaYaZaXaXaYaSaSaS
aSaSaSaYaXaYaXaYaXaXaZaYaYaYaSaSaS
aSaSaSaYaZaXaZaYaZaYaXaXaXaYaSaSaS
aSaSaSaYaYaYaYaYaXaYaYaYaYaYaSaSaS
aSaSaSaSaSaSaSaSaXaSaSaSaSaSaSaSaS
aSaSaSaSaSaSaSaSaSaSaSaSaSaSaSaSaS
aSaSaSaSaSaSaSaSaSaSaSaSaSaSaSaSaS
"}

(1,1,8) = {"
aSaSaSaSaSaSaSaSaSaSaSaSaSaSaSaSaS
aSaSaSaSaSaSaSaSaSaSaSaSaSaSaSaSaS
aSaSaSaSaSaSaSaSaSaSaSaSaSaSaSaSaS
aSaSaSbbacacbbacacacacacacbbaSaSaS
aSaSaSacacacacacbbacacaaacacaSaSaS
aSaSaSacbbbcbcbcbcbcbcbcacbbaSaSaS
aSaSaSacacbcbcbcbcbcbcbcacacaSaSaS
aSaSaSacacbcbcawawawbcbcacacaSaSaS
aSaSaSacacbcbcawawawbcbcbbbbaSaSaS
aSaSaSacbbbcbcawawawbcbcacacaSaSaS
aSaSaSbbacbcbcbcbcbcbcbcacacaSaSaS
aSaSaSacacbcbcbcbcbcbcbcbbacaSaSaS
aSaSaSacbbacacacacacacacacacaSaSaS
aSaSaSacacacbbbbbbacacacacbbaSaSaS
aSaSaSaSaSaSaSaSaSaSaSaSaSaSaSaSaS
aSaSaSaSaSaSaSaSaSaSaSaSaSaSaSaSaS
aSaSaSaSaSaSaSaSaSaSaSaSaSaSaSaSaS
"}

(1,1,9) = {"
aaaaaaaaaaaaaaaaaaaaaaaaaaaabdbdbd
acbeaaacacbfacaaacbgbgbhbibibgbgbj
aaacaaacacaaacaaacbibhbgbgbhbdbdbd
aabkaaacacaaacaaadbgblbgbgbgbdbdbd
aaacbfacacaaacaaadbhbhbhbhbmbdbdbd
aaaaaaaaaaaaacaaacbhbgbgbgbgbdbdbd
bnacbfaaacboacaaacbhbpbgbgbgbdbdbd
aaaaacaaacaaaaaaaebgbhbhbhbhbdbdbd
acaaacaaacacacacacbgbhbgbgbhbqbqbr
acaaacaaaaaaaaacbkbgbhbgbibgbqbqbq
acboadaaaaaaaaaaaabhbhbgblbgbqbqbq
aaaaacacadaaacaaacbibgbgbibgbdbdbd
acaaacacaaaaacaaacbgbhbhbpbpbdbdbd
acadacacbsacacaaacbibgbgbgbgbdbdbd
aaacaaaaboadacaaaabhbgbgbgbgbdbdbd
acacacadacacacacacbibgbgbgbgbdbdbd
aaaaaaaaaaaaaaaaaabhbhbhbhbhbdbdbd
"}

(1,1,10) = {"
bdbdbdbdbdbdbdbdbdbdbdbdbdbdbdbdbd
btbqbdbqbqbqbdbubdbdbdbdbdbvbvbvbv
bdbqbqbqbdblbvbvbvbvbdbdbdbvbdbdbd
bdbdbdbdbdbdbdbdbdbvbvbubvbvbdbwbv
bdbgblbgbgbgbvbvbxbvbvbdbdbdbdbdbv
bdbgbdbdbgbdbdbdbdbdbubdbdbdbubdbv
bdbgbgblbgbdbybvbvbvbvbvbvbvbvbdbv
bdbdbdbdbdbdbdbdbubdbdbdbdbdbvbdbv
bgbgbzbgbgbdbvbAbvbdbvbvbvbdbvbxbv
bdbdbdbdbgbdbvbdbvbvbAbdbAbdbvbdbd
bBbgbgbgbzbdbvbdbAbdbdbdbvbdbvbdby
bdbdbgbdbgbdbAbdbvbdbvbvbvbubvbvbv
bgbgbzbdbgbmbvbdbvbvbubdbdbdbdbdbv
bgbdbdbdbibdbdbdbdbdbvbdbybvbvbvbv
bibdbibgbgbgbAbvbvbvbubdbdbvbdbdbd
bgbgbgbdbdbdbdbdbdbdbdbdbybvbvbvbC
bdbdbdbdbdbdbdbdbdbdbdbdbdbdbdbdbd
"}

(1,1,11) = {"
bDbubEbFbGbHbHbHbHbHbHbHbHbHbHbHbI
bDbubybdbGbHbGbGbGbJbKbJbGbGbGbHbG
bDbvbvbdbGbHbGbGbGbKbJbKbGbGbGbHbG
bDbububdbGbHbGbGbGbJbKbJbGbGbGbHbG
bDbvbvbdbGbHbGbGbGbHbHbHbGbGbGbHbG
bDbvbLbdbGbHbGbMbGbHbHbHbGbGbGbHbG
bDbAbLbdbGbHbGbGbGbHbHbHbGbGbGbHbG
bDbvbvbdbGbHbGbGbGbHbHbHbGbGbGbHbG
bDbNbvbdbGbHbObPbObHbHbHbObPbObHbG
bDbNbLbdbGbHbPbObPbHbHbHbPbObPbHbG
bDbvbvbdbGbHbGbGbGbHbHbHbGbGbGbHbG
bDbvbvbdbGbHbQbRbQbHbHbHbQbRbQbHbG
bDbNbNbdbGbHbRbQbRbHbHbHbRbQbRbHbG
bDbvbvbdbGbHbGbGbGbHbHbHbGbGbGbGbG
bDbvbvbdbGbHbSbTbSbHbHbHbSbTbSbHbG
bUbvbvbdbGbHbTbSbTbHbHbHbTbSbTbHbG
bDbvbvbdbGbGbGbGbGbHbHbHbGbGbGbHbG
"}

(1,1,12) = {"
bVbWahbXbYbXahbZbXcabXcbahbXccahah
bXbXahbXahbXahbXbXahahbXahbXbXbXah
bXbXahcdahbXahcebXahahahahbXahahah
bXbXahbXahbXahbXbXahbXahahbXahbXbX
bXbXcfbXcgbXahchbXbWcibXcjbXahahck
ahclbXbXbXbXbXbXcmbXbXbXbXbXbXbXbX
ahbXbXcnahahbXbXahbXcoahbVahcpbXcq
crbXbXahbXahbVbXahbXbXbXbXbXbXcsah
bWctbXahahahbXbXahbXcubXcvbXbXbXcw
bXbXbXahbXahahbXcxbXahbVahbXbXbXbX
cyahbXczbXbXcAbXahbXbXahbXbXcBahcC
bXahbWbXahcDbXbXahbXbXahbXbXahbXah
bXbXahahahbXbXbXcEbXbXcFbXbXcGahcH
cIahbXbXbXahcJbXbXbXbXbXbXbXbXbXbX
bXahahbXahahbXbXcKbXbXcLbXbXcMbXcN
bXbXahbWahbXbXcOahcPbXahbXbXahbXah
bXbXbXbVbXbXbXbXcQbXbXahbVbWahahah
"}

(1,1,13) = {"
bHbHbGbHbHbHbGbHbHbHbGbHbHbHbGbHbH
bHcRbGbGbGbGbGbGbGbGbGbGbGbGbGbGbH
bGbGbHbHbGbHbHbHcRbHbHbHbGbHbHbGbG
bHbGbHbGbGbGbGbGbGbGbGbGbGbGbHbGbH
bHbGbGbGbHbHbGbHbHbHcRbHbHbGbGbGbH
bHbGbHbGbHbGbGbGbGbGbGbGbHbGbHbGbH
bGbGbHbGcRbGbHbHcRbHbHbGbGbGbHbGbG
bHbGbHbGbHbGbHbGbGbGbHbGbHbGbHbGbH
bHbGcRbGbHbGcRbGbGbGcRbGbHbGcRbGbH
bHbGbHbGbHbGbHbGbGbGbHbGbHbGbHbGbH
bGbGbHbGbGbGbHbHcSbHbHbGcRbGbHbGbG
bHbGbHbGbHbGbGbGbGbGbGbGbHbGbHbGbH
bHbGbGbGbHbHcRbHbHbHbGbHbHbGbGbGbH
bHbGbHbGbGbGbGbGbGbGbGbGbGbGbHbGbH
bGbGbHbHbGbHbHbHcRbHbHbHbGbHbHbGbG
bHbGbGbGbGbGbGbGbGbGbGbGbGbGbGcRbH
bHbHbGbHbHbHbGbHbHbHbGbHbHbHbGbHbH
"}

(1,1,14) = {"
cTcTcTcTcTcTcTcTcTcTcTcTcTcTcTcTcT
cTcTcTcTcTcTcTcTcTcTcTcTcTcTcTcTcT
cTcTcTcTcTcTcTcTcTcTcTcTcTcTcTcTcT
cTcTcTcTcTcTcTcTcTcTcTcTcTcTcTcTcT
cTcTcTcTcTcTcTcTcTcTcTcTcTcTcTcTcT
cTcTcTcTcTcTcTcTcTcTcTcTcTcTcTcTcT
cTcTcTcTcTcTcTcTcTcTcTcTcTcTcTcTcT
cTcTcTcTcTcTcTcTcTcTcTcTcTcTcTcTcT
cTcTcTcTcTcTcTcTcTcTcTcTcTcTcTcTcT
cTcTcTcTcTcTcTcTcTcTcTcTcTcTcTcTcT
cTcTcTcTcTcTcTcTcTcTcTcTcTcTcTcTcT
cTcTcTcTcTcTcTcTcTcTcTcTcTcTcTcTcT
cTcTcTcTcTcTcTcTcTcTcTcTcTcTcTcTcT
cTcTcTcTcTcTcTcTcTcTcTcTcTcTcTcTcT
cTcTcTcTcTcTcTcTcTcTcTcTcTcTcTcTcT
cTcTcTcTcTcTcTcTcTcTcTcTcTcTcTcTcT
cTcTcTcTcTcTcTcTcTcTcTcTcTcTcTcTcT
"}

(1,1,15) = {"
bGbGbGbGbGbGbGbGbGbGbGbGbGbGbGbGbG
auauauaubGauauaubGauauauaubGauauau
aubGbGbGbGaubGaubGaubGcUaubGaubGbG
aubGauaubGauauaubGaubGbGaubGauaubG
aubGbGaubGaubGaubGaubGbGaubGaubGbG
auauauaubGaubGaubGaubGbGaubGauauau
bGbGbGbGbGbGbGbGbGbGbGbGbGbGbGbGbG
bGbGbGbGbGbGbGbGbGbGbGbGbGbGbGbGbG
bGbGbGbGbGbGbGbGbGbGbGbGbGbGbGbGbG
bGbGbGbGbGbGbGbGbGbGbGbGbGbGbGbGbG
bGbGbGbGbGbGbGbGbGbGbGbGbGbGbGbGbG
auauaubGaubGaubGauauaubGauauaubGbG
aubGaubGaubGaubGaubGbGbGaubGauaubG
aubGaubGaubGaubGauaubGbGauauaubGbG
aubGaubGauauaubGaubGbGbGaubGaubGbG
auauaubGbGaubGbGauauaubGaubGbGaubG
bGbGbGbGbGbGbGbGbGbGbGbGbGbGbGbGbG
"}
