"aa" = (/turf/wall/tree,/area)
"ab" = (/obj/weapon/blade,/turf/floor/grass,/area)
"ac" = (/turf/floor/grass,/area)
"ad" = (/mob/bug,/turf/floor/grass,/area)
"ae" = (/mob/moth,/turf/floor/grass,/area)
"af" = (/obj/warp/east1to2,/turf/floor/grass,/area)
"ag" = (/obj/healer,/turf/floor/grass,/area)
"ah" = (/turf/floor/snow,/area)
"ai" = (/obj/warp/north2to12,/turf/floor/snow,/area)
"aj" = (/obj/warp/west2to1,/turf/floor/grass,/area)
"ak" = (/obj/person/girl,/turf/floor/grass,/area)
"al" = (/obj/warp/south2to4,/turf/floor/grass,/area)
"am" = (/turf/wall/fort,/area)
"an" = (/obj/warp/east2to3,/turf/floor/grass,/area)
"ao" = (/obj/warp/west2to4,/turf/floor/grass,/area)
"ap" = (/obj/warp/east2to9,/turf/floor/grass,/area)
"aq" = (/obj/warp/north2to4,/turf/floor/grass,/area)
"ar" = (/obj/warp/south2to6,/turf/floor/grass,/area)
"as" = (/obj/warp/north34to5,/turf/floor/hall,/area)
"at" = (/turf/floor/town/before,/area)
"au" = (/turf/floor/hall,/area)
"av" = (/obj/guard/towntohall,/turf/floor/hall,/area)
"aw" = (/turf/wall/stall,/area)
"ax" = (/obj/warp/west3to2,/turf/floor/town/before,/area)
"ay" = (/obj/warp/north4to2,/turf/floor/town/after,/area)
"az" = (/turf/floor/town/after,/area)
"aA" = (/obj/guard/northgate,/turf/floor/town/after,/area)
"aB" = (/obj/shop/armoury,/turf/floor/town/after,/area)
"aC" = (/obj/warp/west3to2,/turf/floor/town/after,/area)
"aD" = (/obj/guard/westgate,/turf/floor/town/after,/area)
"aE" = (/obj/warp/east4to2,/turf/floor/town/after,/area)
"aF" = (/obj/shop/potion,/turf/floor/town/after,/area)
"aG" = (/obj/shop/inn,/turf/floor/town/after,/area)
"aH" = (/obj/guard/southgate,/turf/floor/town/after,/area)
"aI" = (/obj/warp/south4to2,/turf/floor/town/after,/area)
"aJ" = (/obj/warp/north5to34,/turf/floor/hall,/area)
"aK" = (/obj/weapon/cross,/boss/king,/turf/floor/hall,/area)
"aL" = (/obj/guard/kinghall,/turf/floor/hall,/area)
"aM" = (/obj/guard/hallvist,/turf/floor/hall,/area)
"aN" = (/obj/guard/halltrue,/turf/floor/hall,/area)
"aO" = (/obj/guard/hallarm,/turf/floor/hall,/area)
"aP" = (/obj/warp/north6to2,/turf/floor/grass,/area)
"aQ" = (/obj/person/sand,/turf/floor/grass,/area)
"aR" = (/turf/floor/sand,/area)
"aS" = (/turf/wall/sand,/area)
"aT" = (/obj/flag,/turf/floor/sand,/area)
"aU" = (/obj/warp/south6to7,/turf/floor/sand,/area)
"aV" = (/obj/warp/north7to6,/turf/floor/sand,/area)
"aW" = (/turf/floor/moth,/area)
"aX" = (/turf/wall/moth,/area)
"aY" = (/mob/moth,/turf/floor/sand,/area)
"aZ" = (/obj/weapon/staff,/boss/moth,/turf/floor/sand,/area)
"ba" = (/turf/floor/flower,/area)
"bb" = (/turf/wall/water,/area)
"bc" = (/turf/wall/cave,/area)
"bd" = (/obj/person/wise,/turf/floor/grass,/area)
"be" = (/mob/ranged/bug,/turf/floor/grass,/area)
"bf" = (/turf/floor/earth,/area)
"bg" = (/turf/wall/shade,/area)
"bh" = (/mob/moth,/turf/floor/earth,/area)
"bi" = (/obj/warp/eastmanto9,/turf/floor/earth,/area)
"bj" = (/mob/ranged/moth,/turf/floor/grass,/area)
"bk" = (/mob/ranged/bug,/turf/floor/earth,/area)
"bl" = (/mob/armoured_moth,/turf/floor/earth,/area)
"bm" = (/obj/warp/west9to2,/turf/floor/grass,/area)
"bn" = (/mob/armoured_bug,/turf/floor/grass,/area)
"bo" = (/mob/armoured_bug,/turf/floor/earth,/area)
"bp" = (/turf/floor/earth/ruin,/area)
"bq" = (/obj/warp/east9to10,/turf/floor/earth/ruin,/area)
"br" = (/mob/armoured_moth,/turf/floor/grass,/area)
"bs" = (/obj/warp/west9toman,/turf/floor/earth,/area)
"bt" = (/mob/ranged/moth,/turf/floor/cave,/area)
"bu" = (/turf/floor/cave,/area)
"bv" = (/mob/poisoned/bug,/turf/floor/cave,/area)
"bw" = (/mob/armoured_moth,/turf/floor/cave,/area)
"bx" = (/mob/armoured_bug,/turf/floor/cave,/area)
"by" = (/mob/bug,/turf/floor/earth,/area)
"bz" = (/mob/ranged/bug,/turf/floor/cave,/area)
"bA" = (/obj/warp/west10to9,/turf/floor/earth,/area)
"bB" = (/obj/warp/east10to11,/turf/floor/cave,/area)
"bC" = (/turf/wall/dark,/area)
"bD" = (/obj/weapon/spear,/boss/thief,/turf/floor/cave,/area)
"bE" = (/turf/wall/crack,/area)
"bF" = (/turf/floor/dark,/area)
"bG" = (/turf/wall/hall,/area)
"bH" = (/obj/warp/warpEscape,/turf/floor/dark,/area)
"bI" = (/mob/unbreakable/bug,/turf/floor/dark,/area)
"bJ" = (/mob/unbreakable/moth,/turf/floor/dark,/area)
"bK" = (/mob/moth,/turf/floor/cave,/area)
"bL" = (/obj/weapon/force,/turf/floor/dark,/area)
"bM" = (/mob/bug,/turf/floor/cave,/area)
"bN" = (/mob/armoured_bug,/turf/floor/dark,/area)
"bO" = (/mob/armoured_moth,/turf/floor/dark,/area)
"bP" = (/mob/bug,/turf/floor/dark,/area)
"bQ" = (/mob/moth,/turf/floor/dark,/area)
"bR" = (/mob/poisoned/bug,/turf/floor/dark,/area)
"bS" = (/mob/poisoned/moth,/turf/floor/dark,/area)
"bT" = (/obj/warp/west11to10,/turf/floor/cave,/area)
"bU" = (/obj/crack,/turf/floor/snow,/area)
"bV" = (/turf/wall/snow,/area)
"bW" = (/obj/warp/warpQ1,/turf/floor/warp/Q1,/area)
"bX" = (/obj/warp/warpH2,/turf/floor/warp/H2,/area)
"bY" = (/obj/warp/warpU2,/turf/floor/warp/U2,/area)
"bZ" = (/obj/warp/warpD2,/turf/floor/warp/D2,/area)
"ca" = (/obj/warp/warpT2,/turf/floor/warp/T2,/area)
"cb" = (/obj/warp/south12to2,/turf/floor/snow,/area)
"cc" = (/obj/warp/warpA2,/turf/floor/warp/A2,/area)
"cd" = (/obj/warp/warpA1,/turf/floor/warp/A1,/area)
"ce" = (/obj/warp/warpG1,/turf/floor/warp/G1,/area)
"cf" = (/obj/warp/warpB1,/turf/floor/warp/B1,/area)
"cg" = (/obj/warp/warpE1,/turf/floor/warp/E1,/area)
"ch" = (/obj/warp/warpN2,/turf/floor/warp/N2,/area)
"ci" = (/obj/warp/warpU1,/turf/floor/warp/U1,/area)
"cj" = (/obj/warp/warpK2,/turf/floor/warp/K2,/area)
"ck" = (/obj/warp/warpBoss,/turf/floor/snow,/area)
"cl" = (/obj/warp/warpD1,/turf/floor/warp/D1,/area)
"cm" = (/obj/warp/warpR1,/turf/floor/warp/R1,/area)
"cn" = (/obj/warp/warpT1,/turf/floor/warp/T1,/area)
"co" = (/obj/warp/warpL2,/turf/floor/warp/L2,/area)
"cp" = (/obj/warp/warpL1,/turf/floor/warp/L1,/area)
"cq" = (/obj/warp/warpI2,/turf/floor/warp/I2,/area)
"cr" = (/obj/warp/warpM1,/turf/floor/warp/M1,/area)
"cs" = (/obj/warp/warpE2,/turf/floor/warp/E2,/area)
"ct" = (/obj/warp/warpR2,/turf/floor/warp/R2,/area)
"cu" = (/obj/warp/warpS1,/turf/floor/warp/S1,/area)
"cv" = (/obj/person/dead,/turf/floor/snow,/area)
"cw" = (/obj/warp/warpN1,/turf/floor/warp/N1,/area)
"cx" = (/obj/warp/warpP2,/turf/floor/warp/P2,/area)
"cy" = (/obj/warp/warpC2,/turf/floor/warp/C2,/area)
"cz" = (/obj/warp/warpQ2,/turf/floor/warp/Q2,/area)
"cA" = (/obj/warp/warpJ2,/turf/floor/warp/J2,/area)
"cB" = (/obj/warp/warpM2,/turf/floor/warp/M2,/area)
"cC" = (/obj/warp/warpF2,/turf/floor/warp/F2,/area)
"cD" = (/obj/warp/warpF1,/turf/floor/warp/F1,/area)
"cE" = (/obj/warp/warpO1,/turf/floor/warp/O1,/area)
"cF" = (/obj/warp/warpK1,/turf/floor/warp/K1,/area)
"cG" = (/obj/warp/warpB2,/turf/floor/warp/B2,/area)
"cH" = (/obj/warp/warpC1,/turf/floor/warp/C1,/area)
"cI" = (/obj/warp/warpG2,/turf/floor/warp/G2,/area)
"cJ" = (/obj/warp/warpS2,/turf/floor/warp/S2,/area)
"cK" = (/obj/warp/warpO2,/turf/floor/warp/O2,/area)
"cL" = (/obj/warp/warpP1,/turf/floor/warp/P1,/area)
"cM" = (/obj/warp/warpH1,/turf/floor/warp/H1,/area)
"cN" = (/obj/warp/warpI1,/turf/floor/warp/I1,/area)
"cO" = (/obj/warp/warpJ1,/turf/floor/warp/J1,/area)
"cP" = (/mob/poisoned/fruit,/turf/floor/dark,/area)
"cQ" = (/boss/fruit,/turf/floor/dark,/area)
"cR" = (/turf,/area)
"cS" = (/turf/floor/hall{pixel_x = -16},/area)

(1,1,1) = {"
aaaaaaaaaaaaaaaaaaaaaaaaaaaaaaaaaa
aaabaaacadacacacacacadacacacacacaa
aaaeaaacaaacaaaaacadacaaaaacaaadaa
aaacaaacaaacacaaadaaacaaacaaaaacaa
aaacaaacaaaaaaaaacaaacaaacadacacaa
aaadaaacacacacacacaaacacacacaaaaaa
aaacaaaaadaaadaaaaaaaaaaaaacaaacaf
aaacaaacacaaacacacaaacacadacaaacaa
aaacaaacaaaaaaaaacaaaaaaaaacaaadaa
aaadaaacadacacacacacacacadacacacaa
aaacaaadaaaaaaaaadaaadaaacaaaaacaa
aaacaaacaaagadaaacaaacaaacacaaacaa
aaacaaacaaaaacaaacaaacaaaaacaaadaa
aaadaaacacaaacacacaaacacaaacaaacaa
aaacaaaaaaaaaaaaaaaaaaaaaaacaaacaa
aaacacacacacacacacacacadacacacacaa
aaaaaaaaaaaaaaaaaaaaaaaaaaaaaaaaaa
"}

(1,1,2) = {"
ahahahaiahahahahahahahahahahaaaaaa
aaacacacacacacacacacacaaaaaaaaacac
aaacacacacacacacacacacaaaaacacacac
aaacacacacacacacacaaaaacaaacacacac
aaacacacacacacacacaaaaaaaaacaaaaac
aaaaaaaaaaaaaaaaacaaacacacacacaaac
ajacaaakacacacaaalaaacacaaacaaaaac
aaacaaaaaaaaacamamamaaaaaaacaaacac
aaacaaacacacanamamamaoacacacacacap
aaacacacacacacamamamacacacaaacaaac
aaaaaaaaaaaaaaaaaqaaaaacacaaaaaaac
acaaacacacacacacacacaaaaacaaacaaac
acacaaacacacacacacacacaaaaacacacac
acaaacacacacacacacacacacaaaaacacac
aaacacacacacacacacacacacacaaaaacac
aaacacacacacacacacacacacacacaaaaaa
aaaracacacacacacacacacacacacacaaaa
"}

(1,1,3) = {"
amamasamamamamamatamamamamamamamam
amauavauamatatatatatatatatawawawam
amauauauamatatatatatatatatawawawam
amatatatatatatatatatatatatatatatam
amatatatatatatatatatatatatatatatam
amatatatatatatatatatatatatatatatam
amatatatatatatatatatatatatatatatam
amatatatatatatatatatatatatatatatam
axatatatatatatatatatatatatatatatat
amatatatatatatatatatatatatatatatam
amawawatatatatatatatatatatatatatam
amawawatatatatatatatatatatatawawam
amawawatatatatatatatatatatatawawam
amawawatatatatatatatatatatatawawam
amawawatatatatatatatatatatatawawam
amawawatatatatatatatawawawawawawam
amamamamamamamamatamamamamamamamam
"}

(1,1,4) = {"
amamasamamamamamayamamamamamamamam
amauauauamazazazaAazazazazawawawam
amauauauamazazazazazazazazawaBawam
amazazazazazazazazazazazazazazazam
amazazazazazazazazazazazazazazazam
amazazazazazazazazazazazazazazazam
amazazazazazazazazazazazazazazazam
amazazazazazazazazazazazazazazazam
aCazazazazazazazazazazazazazazaDaE
amazazazazazazazazazazazazazazazam
amawawazazazazazazazazazazazazazam
amawawazazazazazazazazazazazawawam
amawawazazazazazazazazazazazawawam
amawaFazazazazazazazazazazazawawam
amawawazazazazazazazazazazazaGawam
amawawazazazazazaHazawawawawawawam
amamamamamamamamaIamamamamamamamam
"}

(1,1,5) = {"
amauaJauamamamamamamamamamamamamam
amauauauamauauauamamamauauauamamam
amauauauamauamauamamamauaKauamamam
amauauauaLauamauamamamauauauamamam
amamamamamamamauamamamamauamamamam
amauauauauauauauamamamauauauamamam
amauamamamamamamamamamauauauamamam
amauauauauauauaMauamauauauauauamam
amamamamamamamauamauauauauauauauam
amauauauauauauauamauamamamamamauam
amauamamamamamamamaNauauauauamauam
amauauauauauauauauauamauauauamauam
amauamamamamamamamauamauauauamauam
amauamauauauauauauauamamamaOamauam
amauamauamamamamamamauauauauauauam
amauauauauauauauauamauauauauauauam
amamamamamamamamauamamamamamamamam
"}

(1,1,6) = {"
aPacacacacacacacacacacacacacacacaQ
acacacacacacacacacacacacacacacacac
acacacacacacacacacacacacacacacacac
aRaRaRaRaRaRaRaRaRaRaRaRaRaRaRaRaR
aRaRaRaRaRaRaRaRaRaRaRaRaRaRaRaRaR
aRaRaRaRaRaRaRaRaRaRaRaRaRaRaRaRaR
aSaTaSaSaSaSaSaSaTaSaSaSaSaSaSaTaS
aSaRaSaSaRaRaSaSaRaSaSaSaSaRaSaRaS
aSaRaRaRaSaRaRaRaRaRaRaRaSaRaSaRaS
aSaRaSaSaSaSaSaSaRaSaSaRaSaRaRaRaS
aSaRaSaRaRaRaSaSaRaRaSaRaSaRaSaRaS
aSaRaRaRaSaRaSaRaRaSaSaRaRaRaSaRaS
aSaRaSaSaSaRaSaSaRaSaSaSaSaSaSaRaS
aSaRaSaRaRaRaSaSaRaRaRaRaRaRaRaRaS
aSaSaSaTaSaSaSaSaSaSaSaSaSaSaSaSaS
aRaRaRaRaRaRaRaRaRaRaRaRaRaRaRaRaR
aRaRaRaRaRaRaRaRaRaRaRaRaRaRaRaRaU
"}

(1,1,7) = {"
aRaRaRaRaRaRaRaRaRaRaRaRaRaRaRaRaV
aRaRaRaRaRaRaRaRaRaRaRaRaRaRaRaRaR
aRaRaRaRaRaRaRaRaWaRaRaRaRaRaRaRaR
aRaRaRaXaXaXaXaXaWaXaXaXaXaXaRaRaR
aRaRaRaXaYaWaYaWaYaWaXaWaXaXaRaRaR
aRaRaRaXaWaXaXaXaXaWaXaWaXaXaRaRaR
aRaRaRaXaWaYaWaXaXaYaYaWaXaXaRaRaR
aRaRaRaXaXaXaXaXaXaXaXaXaXaXaRaRaR
aRaRaWaWaYaXaWaYaZaXaWaXaYaWaWaRaR
aRaRaRaXaWaXaWaXaXaXaWaXaWaXaRaRaR
aRaRaRaXaWaXaWaXaXaXaYaWaWaXaRaRaR
aRaRaRaXaWaXaWaXaWaWaYaXaXaXaRaRaR
aRaRaRaXaYaWaYaXaYaXaWaWaWaXaRaRaR
aRaRaRaXaXaXaXaXaWaXaXaXaXaXaRaRaR
aRaRaRaRaRaRaRaRaWaRaRaRaRaRaRaRaR
aRaRaRaRaRaRaRaRaRaRaRaRaRaRaRaRaR
aRaRaRaRaRaRaRaRaRaRaRaRaRaRaRaRaR
"}

(1,1,8) = {"
aRaRaRaRaRaRaRaRaRaRaRaRaRaRaRaRaR
aRaRaRaRaRaRaRaRaRaRaRaRaRaRaRaRaR
aRaRaRaRaRaRaRaRaRaRaRaRaRaRaRaRaR
aRaRaRbaacacbaacacacacacacbaaRaRaR
aRaRaRacacacacacbaacacaaacacaRaRaR
aRaRaRacbabbbbbbbbbbbbbbacbaaRaRaR
aRaRaRacacbbbbbbbbbbbbbbacacaRaRaR
aRaRaRacacbbbbawawawbbbbacacaRaRaR
aRaRaRacacbbbbawawawbbbbbabaaRaRaR
aRaRaRacbabbbbawawawbbbbacacaRaRaR
aRaRaRbaacbbbbbbbbbbbbbbacacaRaRaR
aRaRaRacacbbbbbbbbbbbbbbbaacaRaRaR
aRaRaRacbaacacacacacacacacacaRaRaR
aRaRaRacacacbababaacacacacbaaRaRaR
aRaRaRaRaRaRaRaRaRaRaRaRaRaRaRaRaR
aRaRaRaRaRaRaRaRaRaRaRaRaRaRaRaRaR
aRaRaRaRaRaRaRaRaRaRaRaRaRaRaRaRaR
"}

(1,1,9) = {"
aaaaaaaaaaaaaaaaaaaaaaaaaaaabcbcbc
acbdaaacacbeacaaacbfbfbgbhbhbfbfbi
aaacaaacacaaacaaacbhbgbfbfbgbcbcbc
aabjaaacacaaacaaadbfbkbfbfbfbcbcbc
aaacbeacacaaacaaadbgbgbgbgblbcbcbc
aaaaaaaaaaaaacaaacbgbfbfbfbfbcbcbc
bmacbeaaacbnacaaacbgbobfbfbfbcbcbc
aaaaacaaacaaaaaaaebfbgbgbgbgbcbcbc
acaaacaaacacacacacbfbgbfbfbgbpbpbq
acaaacaaaaaaaaacbjbfbgbfbhbfbpbpbp
acbnadaaaaaaaaaaaabgbgbfbkbfbpbpbp
aaaaacacadaaacaaacbhbfbfbhbfbcbcbc
acaaacacaaaaacaaacbfbgbgbobobcbcbc
acadacacbracacaaacbhbfbfbfbfbcbcbc
aaacaaaabnadacaaaabgbfbfbfbfbcbcbc
acacacadacacacacacbhbfbfbfbfbcbcbc
aaaaaaaaaaaaaaaaaabgbgbgbgbgbcbcbc
"}

(1,1,10) = {"
bcbcbcbcbcbcbcbcbcbcbcbcbcbcbcbcbc
bsbpbcbpbpbpbcbtbcbcbcbcbcbubububu
bcbpbpbpbcbkbububububcbcbcbubcbcbc
bcbcbcbcbcbcbcbcbcbububtbububcbvbu
bcbfbkbfbfbfbububwbububcbcbcbcbcbu
bcbfbcbcbfbcbcbcbcbcbtbcbcbcbtbcbu
bcbfbfbkbfbcbxbububububububububcbu
bcbcbcbcbcbcbcbcbtbcbcbcbcbcbubcbu
bfbfbybfbfbcbubzbubcbubububcbubwbu
bcbcbcbcbfbcbubcbububzbcbzbcbubcbc
bAbfbfbfbybcbubcbzbcbcbcbubcbubcbx
bcbcbfbcbfbcbzbcbubcbubububtbububu
bfbfbybcbfblbubcbububtbcbcbcbcbcbu
bfbcbcbcbhbcbcbcbcbcbubcbxbubububu
bhbcbhbfbfbfbzbubububtbcbcbubcbcbc
bfbfbfbcbcbcbcbcbcbcbcbcbxbubububB
bcbcbcbcbcbcbcbcbcbcbcbcbcbcbcbcbc
"}

(1,1,11) = {"
bCbtbDbEbFbGbGbGbGbGbGbGbGbGbGbGbH
bCbtbxbcbFbGbFbFbFbIbJbIbFbFbFbGbF
bCbububcbFbGbFbFbFbJbIbJbFbFbFbGbF
bCbtbtbcbFbGbFbFbFbIbJbIbFbFbFbGbF
bCbububcbFbGbFbFbFbGbGbGbFbFbFbGbF
bCbubKbcbFbGbFbLbFbGbGbGbFbFbFbGbF
bCbzbKbcbFbGbFbFbFbGbGbGbFbFbFbGbF
bCbububcbFbGbFbFbFbGbGbGbFbFbFbGbF
bCbMbubcbFbGbNbObNbGbGbGbNbObNbGbF
bCbMbKbcbFbGbObNbObGbGbGbObNbObGbF
bCbububcbFbGbFbFbFbGbGbGbFbFbFbGbF
bCbububcbFbGbPbQbPbGbGbGbPbQbPbGbF
bCbMbMbcbFbGbQbPbQbGbGbGbQbPbQbGbF
bCbububcbFbGbFbFbFbGbGbGbFbFbFaubF
bCbububcbFbGbRbSbRbGbGbGbRbSbRbGbF
bTbububcbFbGbSbRbSbGbGbGbSbRbSbGbF
bCbububcbFbFbFbFbFbGbGbGbFbFbFbGbF
"}

(1,1,12) = {"
ahbUahbVbWbVahbXbVbYbVbZahbVcaahah
bVbVahbVahbVahbVbVahahbVahbVbVbVah
bVbVahcbahbVahccbVahahahahbVahahah
bVbVahbVahbVahbVbVahbVahahbVahbVbV
bVbVcdbVcebVahcfbVbUcgbVchbVahahci
ahcjbVbVbVbVbVbVckbVbVbVbVbVbVbVbV
ahbVbVclahahbVbVahbVcmahahahcnbVco
cpbVbVahbVahahbVahbVbVbVbVbVbVcqah
bUcrbVahahahbVbVahbVcsbVctbVbVbVcu
bVbVbVahbVahahbVcvbVahahahbVbVbVbV
cwahbVcxbVbVcybVahbVbVahbVbVczahcA
bVahbUbVahcBbVbVahbVbVahbVbVahbVah
bVbVahahahbVbVbVcCbVbVcDbVbVcEahcF
cGahbVbVbVahcHbVbVbVbVbVbVbVbVbVbV
bVahahbVahahbVbVcIbVbVcJbVbVcKbVcL
bVbVahbUahbVbVcMahcNbVahbVbVahbVah
bVbVbVahbVbVbVbVcObVbVahahbUahahah
"}

(1,1,13) = {"
bGbGbFbGbGbGbFbGbGbGbFbGbGbGbFbGbG
bGcPbFbFbFbFbFbFbFbFbFbFbFbFbFbFbG
bFbFbGbGbFbGbGbGcPbGbGbGbFbGbGbFbF
bGbFbGbFbFbFbFbFbFbFbFbFbFbFbGbFbG
bGbFbFbFbGbGbFbGbGbGcPbGbGbFbFbFbG
bGbFbGbFbGbFbFbFbFbFbFbFbGbFbGbFbG
bFbFbGbFcPbFbGbGcPbGbGbFbFbFbGbFbF
bGbFbGbFbGbFbGbFbFbFbGbFbGbFbGbFbG
bGbFcPbFbGbFcPbFbFbFcPbFbGbFcPbFbG
bGbFbGbFbGbFbGbFbFbFbGbFbGbFbGbFbG
bFbFbGbFbFbFbGbGcQbGbGbFcPbFbGbFbF
bGbFbGbFbGbFbFbFbFbFbFbFbGbFbGbFbG
bGbFbFbFbGbGcPbGbGbGbFbGbGbFbFbFbG
bGbFbGbFbFbFbFbFbFbFbFbFbFbFbGbFbG
bFbFbGbGbFbGbGbGcPbGbGbGbFbGbGbFbF
bGbFbFbFbFbFbFbFbFbFbFbFbFbFbFcPbG
bGbGbFbGbGbGbFbGbGbGbFbGbGbGbFbGbG
"}

(1,1,14) = {"
cRcRcRcRcRcRcRcRcRcRcRcRcRcRcRcRcR
cRcRcRcRcRcRcRcRcRcRcRcRcRcRcRcRcR
cRcRcRcRcRcRcRcRcRcRcRcRcRcRcRcRcR
cRcRcRcRcRcRcRcRcRcRcRcRcRcRcRcRcR
cRcRcRcRcRcRcRcRcRcRcRcRcRcRcRcRcR
cRcRcRcRcRcRcRcRcRcRcRcRcRcRcRcRcR
cRcRcRcRcRcRcRcRcRcRcRcRcRcRcRcRcR
cRcRcRcRcRcRcRcRcRcRcRcRcRcRcRcRcR
cRcRcRcRcRcRcRcRcRcRcRcRcRcRcRcRcR
cRcRcRcRcRcRcRcRcRcRcRcRcRcRcRcRcR
cRcRcRcRcRcRcRcRcRcRcRcRcRcRcRcRcR
cRcRcRcRcRcRcRcRcRcRcRcRcRcRcRcRcR
cRcRcRcRcRcRcRcRcRcRcRcRcRcRcRcRcR
cRcRcRcRcRcRcRcRcRcRcRcRcRcRcRcRcR
cRcRcRcRcRcRcRcRcRcRcRcRcRcRcRcRcR
cRcRcRcRcRcRcRcRcRcRcRcRcRcRcRcRcR
cRcRcRcRcRcRcRcRcRcRcRcRcRcRcRcRcR
"}

(1,1,15) = {"
bFbFbFbFbFbFbFbFbFbFbFbFbFbFbFbFbF
auauauaubFauauaubFauauauaubFauauau
aubFbFbFbFaubFaubFaubFcSaubFaubFbF
aubFauaubFauauaubFaubFbFaubFauaubF
aubFbFaubFaubFaubFaubFbFaubFaubFbF
auauauaubFaubFaubFaubFbFaubFauauau
bFbFbFbFbFbFbFbFbFbFbFbFbFbFbFbFbF
bFbFbFbFbFbFbFbFbFbFbFbFbFbFbFbFbF
bFbFbFbFbFbFbFbFbFbFbFbFbFbFbFbFbF
bFbFbFbFbFbFbFbFbFbFbFbFbFbFbFbFbF
bFbFbFbFbFbFbFbFbFbFbFbFbFbFbFbFbF
auauaubFaubFaubFauauaubFauauaubFbF
aubFaubFaubFaubFaubFbFbFaubFauaubF
aubFaubFaubFaubFauaubFbFauauaubFbF
aubFaubFauauaubFaubFbFbFaubFaubFbF
auauaubFbFaubFbFauauaubFaubFbFaubF
bFbFbFbFbFbFbFbFbFbFbFbFbFbFbFbFbF
"}
